1111111111111111111111111111111111
1E0000A00000000C00000C000000000001
1010010100100000101001000000010101
101001001010101C001001000000010101
1P0000000C00CA000000A000C0000A00C1
1C000A000C00C0000000C00000000000C1
1111111111111111111111111111111111